2 1
7 5
........
.xxxxxx.
.x....x.
.x....x.
......x.
........